############################
#..........................#
#...####...................#
#...####...................#
#........###...@...........#
#..##....###...............#
#........###..#######......#
#.....................##...#
#.............#######......#
#.............#######......#
#..........................#
############################
