################
#..............#
#...####.......#
#..............#
#........###...
#..##..........#
#..........###.#
#......@.......#
#..............#
#..............#
#..............#
################
